Stage 1
#####
#OoP#
#####
=====
Stage 2
  #######
###  O  ###
#    o    #
# Oo P oO #
###  o  ###
 #   O  # 
 ########
=====
Stage 3
#####
#P  ##
#Oo0 #
#  # #
#    #
######
=====
Stage 4
 ##### 
##P  ##
#  #  #
# o0o #
#  O  #
## O ##
 #####
=====
Stage 5
######
#    ###
#   OO #
# oooP #
#  # O #
########
=====
Stage 6
######
#    ###
#OO  oO#
# oooP #
#  # O #
########